S..#####.#..###
.#.....#.##.#..
..##.#...#....#
#...####...####
...#.....###..#
##.####.##...##
...###....#####
.#...##.#.##..#
.##.#...#...###
###..####.#####
###.##.#..##..#
#...#..#.##..##
..##..#.....###
#####.##.##.###
#....###..#...X